01111100111110
1E1111001111X1
11E11111111X11
11111000011111
1E1111111111X1
1E1111111111X1
11111000011111
11E11111111X11
1E1111001111X1
01111100111110